1111111111111111111111111111111
1444444444444444444444444444441
1444444441000000000014444444441
1444444441300000000014444444441
1000500001111111111110005000001
1000000000000020000000000000001
1111111111111111111111111111111