1111111111111111111111111111111
1444444444444444444444444444441
1444444441          14444444441
14444444413         14444444441
1    5   111111111111   5     1
1             2               1
1111111111111111111111111111111